NO ./png32.png
SO ./png32.png
  WE          ./png32.png           
      EA        ./png32.png

F 63,63,63
C 13,13,56

11111111111111111111111111111
10000000000000000000000000001
10000000000011101111000010001
10011111100000000011001111101
10000000000000000000000000001
10001111111100000000000000001
10000000000000000000111111101
10000000111111110011100000001
10000001111100000100000000001
10111111111100000000000000001
10000000000111000000000000001
10000000000111000000000000001
10000001111000010010010000001
10000000000001010010010100001
10111111100000000000011000001
1000000000000000000000000N001
11111111111111111111111111111
